cp,front_time,end_time,ans_time,total_time,db,MCS,quality/70
7,216,101,3,320,-43.00,7,48
1,52,208,3,263,-61.00,7,67
1,52,245,4,301,-49.00,7,49
8,240,0,3,243,-64.00,7,61
8,240,0,3,243,-47.00,7,46
8,240,0,3,243,-63.00,7,63
8,240,0,3,243,-71.00,7,47
6,185,224,3,412,-64.00,7,39
8,241,0,3,244,-43.00,7,46
8,240,0,3,243,-64.00,7,67
8,240,0,3,243,-71.00,7,46
8,240,0,3,243,-62.00,7,39
0,25,296,3,324,-48.00,7,48
8,241,0,3,244,-60.00,6,62
8,240,0,3,243,-43.00,7,50
8,240,0,3,243,-62.00,7,67
8,240,0,3,243,-70.00,6,48
5,159,114,3,276,-63.00,6,40
8,241,0,3,244,-48.00,6,47
8,240,0,3,243,-62.00,6,62
8,240,0,3,243,-48.00,6,48
8,240,0,3,243,-62.00,6,62
2,80,274,3,357,-69.00,7,48
8,241,0,3,244,-63.00,7,41
8,240,0,3,243,-49.00,6,47
8,240,0,3,243,-59.00,6,61
8,240,0,3,243,-72.00,6,51
0,25,231,4,260,-63.00,6,38
8,241,0,3,244,-71.00,6,47
8,241,0,3,244,-61.00,6,39
8,241,0,3,244,-49.00,6,49
8,241,0,3,244,-58.00,6,61
8,241,0,3,244,-50.00,6,52
8,241,0,3,244,-63.00,6,60
8,241,0,3,244,-50.00,6,47
8,241,0,3,244,-62.00,6,60
8,241,0,3,244,-48.00,6,48
2,81,316,4,401,-63.00,6,62
8,240,0,3,243,-73.00,6,47
8,240,0,3,243,-62.00,2,37
8,240,0,3,243,-49.00,6,48
8,240,0,3,243,-59.00,6,61
0,25,216,3,244,-75.00,6,51
8,240,0,3,243,-64.00,6,35
8,241,0,3,244,-43.00,6,46
8,240,0,3,243,-61.00,6,67
8,240,0,3,243,-43.00,6,49
2,81,286,3,370,-62.00,6,67
8,240,0,3,243,-73.00,6,48
8,240,0,3,243,-55.00,6,37
8,240,0,3,243,-75.00,6,55
8,240,0,3,243,-57.00,6,35
6,186,152,3,341,-49.00,7,53
8,240,0,3,243,-56.00,7,61
8,240,0,3,243,-49.00,6,54
8,240,0,3,243,-63.00,6,61
8,240,0,3,243,-74.00,6,47
7,215,144,3,362,-54.00,7,36
8,240,0,3,243,-43.00,7,56
8,241,0,3,244,-63.00,6,67
8,241,0,3,244,-48.00,6,47
8,241,0,3,244,-58.00,6,62
6,186,230,3,419,-48.00,6,52
8,241,0,3,244,-61.00,6,62
8,241,0,3,244,-50.00,6,49
8,241,0,3,244,-62.00,6,60
8,240,0,3,243,-49.00,6,48
2,81,147,3,231,-56.00,6,61
8,240,0,3,243,-48.00,7,54
8,241,0,3,244,-61.00,6,62
8,241,0,3,244,-50.00,6,49
8,241,0,3,244,-62.00,6,60
0,25,219,3,247,-71.00,6,48
8,240,0,3,243,-57.00,7,39
8,241,0,3,244,-48.00,6,53
8,241,0,3,244,-56.00,6,62
8,241,0,3,244,-72.00,6,54
5,160,110,3,273,-57.00,6,38
8,240,0,3,243,-72.00,7,53
8,241,0,3,244,-59.00,6,38
8,241,0,3,244,-49.00,6,51
8,241,0,3,244,-58.00,6,61
8,241,0,3,244,-48.00,6,52
8,241,0,3,244,-63.00,6,62
8,241,0,3,244,-48.00,6,47
8,241,0,3,244,-62.00,6,62
8,241,0,3,244,-73.00,6,48
4,133,60,3,196,-56.00,7,37
3,106,159,3,268,-43.00,7,54
3,106,123,3,232,-54.00,7,67
3,107,109,3,219,-71.00,7,56
3,106,150,3,259,-62.00,7,39
3,107,121,3,231,-71.00,7,48
3,106,83,3,192,-55.00,7,39
3,106,165,3,274,-49.00,7,55
3,106,74,3,183,-56.00,7,61
3,107,115,4,226,-74.00,6,54
3,107,173,3,283,-63.00,7,36
3,106,141,3,250,-72.00,7,47
3,106,89,3,198,-55.00,7,38
3,107,83,3,193,-49.00,6,55
3,106,146,3,255,-58.00,7,61
3,107,103,3,213,-44.00,7,52
3,107,159,3,269,-59.00,7,66
3,106,107,3,216,-43.00,7,51
3,106,133,3,242,-62.00,6,67
3,106,89,4,199,-72.00,7,48
3,107,118,3,228,-63.00,6,38
3,106,99,3,208,-68.00,7,47
3,106,54,4,164,-63.00,6,42
3,107,130,4,241,-72.00,7,47
3,107,79,3,189,-63.00,6,38
3,107,167,3,277,-72.00,6,47
3,107,90,4,201,-63.00,6,38
3,107,90,3,200,-73.00,7,47
3,107,227,3,337,-63.00,7,37
3,107,122,3,232,-71.00,6,47
3,106,108,3,217,-58.00,7,39
3,106,190,3,299,-47.00,7,52
3,107,106,3,216,-63.00,7,63
3,106,98,3,207,-48.00,7,47
3,106,174,3,283,-56.00,7,62
3,106,58,4,168,-70.00,7,54
3,107,121,4,232,-63.00,7,40
3,107,219,3,329,-49.00,7,47
3,106,239,4,349,-62.00,7,61
3,107,187,3,297,-71.00,7,48
3,106,187,4,297,-62.00,7,39
3,107,82,3,192,-49.00,7,48
3,106,98,3,207,-59.00,7,61
3,107,207,3,317,-73.00,7,51
3,107,85,3,195,-58.00,6,37
3,106,88,3,197,-70.00,7,52
3,106,190,3,299,-62.00,7,40
3,106,305,3,414,-72.00,7,48
3,106,88,3,197,-64.00,7,38
3,107,139,3,249,-70.00,7,46
3,106,106,3,215,-63.00,7,40
3,106,102,3,211,-49.00,7,47
3,107,188,3,298,-63.00,7,61
3,106,116,3,225,-42.00,7,47
3,106,117,3,226,-63.00,7,68
3,107,105,3,215,-69.00,7,47
3,106,85,4,195,-64.00,6,41
3,106,127,3,236,-71.00,7,46
3,106,98,3,207,-58.00,7,39
3,106,92,3,201,-72.00,7,52
3,106,101,3,210,-64.00,7,38
3,106,171,3,280,-49.00,7,46
3,107,181,2,290,-61.00,7,61
3,107,124,3,234,-71.00,7,49
3,106,157,3,266,-59.00,6,39
3,106,113,3,222,-71.00,7,51
3,107,114,3,224,-60.00,5,39
3,107,85,3,195,-71.00,6,50
3,107,112,3,222,-62.00,7,39
3,107,83,3,193,-49.00,7,48
3,107,199,3,309,-63.00,7,61
3,107,91,4,202,-47.00,6,47
3,106,99,3,208,-64.00,7,63
3,107,212,3,322,-47.00,7,46
3,107,151,4,262,-57.00,6,63
3,106,138,3,247,-49.00,7,53
3,107,114,3,224,-57.00,7,61
3,106,77,3,186,-70.00,7,53
3,107,101,4,212,-57.00,7,40
3,106,213,3,322,-49.00,7,53
3,107,62,3,172,-62.00,6,61
3,107,52,4,163,-41.00,7,48
3,106,183,3,292,-59.00,7,69
3,107,135,3,245,-48.00,7,51
3,106,125,3,234,-57.00,7,62
3,106,127,3,236,-42.00,7,53
3,106,181,3,290,-60.00,6,68
3,107,188,4,299,-43.00,7,50
3,106,103,3,212,-60.00,7,67
3,107,161,4,272,-72.00,7,50
3,106,215,4,325,-62.00,7,38
3,106,103,3,212,-48.00,6,48
3,107,115,3,225,-62.00,7,62
3,107,58,3,168,-71.00,7,48
3,106,55,3,164,-59.00,7,39
3,106,224,3,333,-70.00,7,51
3,106,143,3,252,-62.00,7,40
3,107,110,3,220,-49.00,7,48
3,106,65,3,174,-57.00,7,61
3,106,196,4,306,-43.00,6,53
3,107,59,3,169,-62.00,7,67
3,106,151,4,261,-70.00,7,48
3,107,162,3,272,-61.00,7,40
3,106,84,3,193,-49.00,6,49
3,107,133,3,243,-59.00,5,61
3,107,91,3,201,-70.00,5,51
3,106,95,3,204,-62.00,4,40
3,107,2020,3,2130,-63.00,5,36
8,240,0,3,243,-72.00,4,47
8,241,0,3,244,-62.00,7,38
3,107,20,3,130,-55.00,4,38
8,240,0,3,243,-70.00,7,55
8,241,0,3,244,-55.00,4,40
8,241,0,3,244,-71.00,4,55
8,241,0,3,244,-57.00,5,39
0,26,56,4,86,-70.00,5,53
8,241,0,3,244,-58.00,7,40
8,241,0,3,244,-50.00,7,52
8,241,0,3,244,-56.00,7,60
8,241,0,3,244,-50.00,7,54
5,159,10,3,172,-55.00,6,60
8,240,0,3,243,-50.00,6,55
8,241,0,3,244,-66.00,7,60
8,241,0,3,244,-50.00,7,44
8,241,0,3,244,-65.00,7,60
7,216,0,3,219,-69.00,7,45
8,240,0,3,243,-66.00,6,41
8,241,0,2,243,-69.00,7,44
8,241,0,3,244,-64.00,7,41
8,241,0,3,244,-71.00,7,46
0,26,59,4,89,-65.00,6,39
0,25,55,3,83,-68.00,6,45
0,25,154,3,182,-65.00,6,42
0,25,50,3,78,-69.00,6,45
0,25,612,3,640,-63.00,5,41
0,26,49,3,78,-48.00,6,47
0,25,59,3,87,-64.00,6,62
0,25,110,3,138,-50.00,6,46
0,25,53,3,81,-55.00,6,60
0,25,54,3,82,-49.00,6,55
0,25,54,4,83,-65.00,6,61
0,25,60,3,88,-70.00,7,45
0,25,51,4,80,-65.00,7,40
0,25,54,3,82,-70.00,7,45
0,25,51,3,79,-65.00,7,40
0,25,49,3,77,-48.00,7,45
0,25,55,3,83,-65.00,7,62
0,25,51,3,79,-70.00,7,45
0,25,49,3,77,-65.00,7,40
0,25,51,4,80,-69.00,7,45
0,26,55,2,83,-54.00,5,41
0,25,81,3,109,-70.00,7,56
0,25,56,4,85,-54.00,6,40
0,25,59,3,87,-69.00,7,56
0,25,85,3,113,-67.00,7,41
0,26,58,4,88,-43.00,6,43
0,25,61,3,89,-67.00,5,67
0,25,62,3,90,-48.00,6,43
0,25,54,3,82,-53.00,6,62
0,25,53,3,81,-49.00,4,57
0,25,51,3,79,-66.00,5,61
0,25,518,3,546,-69.00,4,44
0,25,109,3,137,-66.00,5,41
0,25,49,3,77,-69.00,5,44
0,25,77,3,105,-54.00,6,41
0,25,54,3,82,-69.00,5,56
0,25,112,3,140,-55.00,5,41
0,25,201,3,229,-70.00,5,55
0,25,291,4,320,-55.00,6,40
0,25,142,3,170,-70.00,4,55
0,25,376,3,404,-56.00,5,40
0,25,388,3,416,-49.00,6,54
0,25,521,3,549,-66.00,5,61
0,25,57,4,86,-49.00,5,44
0,25,57,3,85,-56.00,3,61
0,25,51,3,79,-72.00,5,54
0,25,51,3,79,-67.00,5,38
0,25,51,3,79,-70.00,5,43
0,25,48,3,76,-54.00,5,40
0,25,58,3,86,-49.00,4,56
0,25,154,3,182,-65.00,4,61
0,25,146,3,174,-73.00,5,45
0,25,48,3,76,-56.00,5,37
0,25,54,3,82,-73.00,5,54
0,25,67,3,95,-66.00,4,37
0,25,76,3,104,-49.00,5,44
0,26,51,3,80,-66.00,5,61
0,25,49,3,77,-71.00,5,44
0,25,73,4,102,-56.00,6,39
0,25,186,3,214,-49.00,6,54
0,25,48,3,76,-64.00,5,61
0,25,150,3,178,-72.00,3,46
0,25,224,3,252,-62.00,3,38
0,25,109,3,137,-72.00,4,48
0,25,181,3,209,-63.00,4,38
0,25,193,3,221,-48.00,5,47
0,25,249,3,277,-66.00,5,62
0,25,359,3,387,-70.00,4,44
0,25,64,3,92,-55.00,3,40
0,25,261,3,289,-70.00,4,55
0,25,509,3,537,-65.00,4,40
0,25,140,4,169,-70.00,4,45
0,25,4633,3,4661,-66.00,4,40
0,25,223,3,251,-70.00,4,44
0,25,52,4,81,-66.00,2,40
0,25,47,3,75,-69.00,4,44
0,25,56,4,85,-67.00,4,41
0,25,132,3,160,-51.00,4,43
0,25,51,3,79,-67.00,5,59
0,25,2412,3,2440,-73.00,4,43
0,25,112,3,140,-55.00,5,37
0,25,93,4,122,-51.00,6,55
0,25,273,4,302,-67.00,5,59
0,25,525,3,553,-52.00,5,43
0,25,184,3,212,-67.00,3,58
0,25,246,3,274,-70.00,4,43
0,25,192,3,220,-67.00,3,40
0,25,209,3,237,-70.00,4,43
0,25,193,3,221,-68.00,3,40
0,25,97,3,125,-71.00,4,42
0,25,226,4,255,-68.00,4,39
0,25,101,3,129,-71.00,4,42
0,25,91,4,120,-66.00,4,39
0,25,154,3,182,-73.00,4,44
0,25,132,3,160,-53.00,4,37
0,25,96,4,125,-73.00,4,57
0,25,144,3,172,-53.00,4,37
0,25,204,3,232,-52.00,4,57
0,25,167,3,195,-54.00,5,58
0,25,380,3,408,-69.00,4,56
0,25,722,3,750,-53.00,4,41
0,25,3440,3,3468,-71.00,4,57
8,241,0,3,244,-63.00,1,39
8,241,0,3,244,-53.00,1,47
8,241,0,3,244,-66.00,4,57
1,52,10756,3,10811,-69.00,4,44
4,133,20,3,156,-57.00,4,41
4,133,565,3,701,-70.00,4,53
4,133,23,2,158,-56.00,4,40
4,133,20,4,157,-52.00,4,54
4,133,39,3,175,-68.00,4,58
4,133,25,4,162,-69.00,5,42
4,133,20,3,156,-69.00,3,41
4,133,1838,3,1974,-68.00,4,41
4,133,27,2,162,-60.00,4,42
4,133,20,3,156,-52.00,4,50
4,133,19,4,156,-68.00,3,58
4,133,254,3,390,-53.00,3,42
4,133,20,3,156,-60.00,2,57
4,133,4483,3,4619,-69.00,3,50
7,216,178,3,397,-57.00,3,41
8,241,0,3,244,-52.00,3,53
8,240,0,3,243,-68.00,2,58
5,159,11,3,173,-75.00,6,52
8,240,0,3,243,-57.00,6,35
8,240,0,3,243,-62.00,6,53
8,240,0,3,243,-57.00,2,48
8,240,0,3,243,-62.00,5,53
4,133,22470,3,22606,-73.00,5,48
5,159,10,3,172,-75.00,5,37
5,160,9,4,173,-76.00,5,35
5,159,10,3,172,-60.00,4,34
5,160,10,4,174,-58.00,4,50
5,159,11,3,173,-75.00,3,52
5,160,10,4,174,-78.00,3,35
5,160,13,3,176,-79.00,3,32
5,160,10,4,174,-75.00,3,31
5,160,10,3,173,-62.00,4,35
5,159,14,3,176,-76.00,4,48
5,159,10,3,172,-65.00,4,34
5,159,10,3,172,-72.00,5,45
5,160,10,3,173,-78.00,4,38
5,159,10,3,172,-75.00,4,32
5,160,13,3,176,-78.00,4,35
5,159,9,4,172,-74.00,4,32
5,160,10,3,173,-57.00,4,36
5,160,10,3,173,-73.00,5,53
5,159,10,3,172,-78.00,5,37
5,160,11,4,175,-52.00,4,32
5,160,10,4,174,-59.00,4,58
5,160,10,3,173,-50.00,4,51
5,159,10,3,172,-68.00,4,60
5,160,10,3,173,-70.00,5,42
5,160,11,3,174,-70.00,5,40
5,159,10,3,172,-50.00,5,40
5,159,10,3,172,-52.00,2,30
5,160,9,4,173,-77.00,3,58
5,160,10,3,173,-76.00,3,33
5,159,2009,3,2171,-80.00,3,53
8,241,0,3,244,-74.00,3,30
0,25,165,3,193,-51.00,3,36
8,241,0,3,244,-77.00,3,59
1,53,275,4,332,-77.00,3,33
8,241,0,3,244,-56.00,3,33
8,241,0,3,244,-53.00,3,54
8,241,0,3,244,-56.00,4,57
3,107,19,3,129,-52.00,4,54
8,241,0,3,244,-57.00,4,58
8,241,0,3,244,-51.00,4,53
3,107,20,3,130,-76.00,3,59
8,240,0,3,243,-51.00,3,34
1,52,163,4,219,-62.00,4,59
8,241,0,3,244,-74.00,4,48
0,25,125,3,153,-74.00,5,36
8,240,0,3,243,-52.00,4,36
3,106,20,3,129,-74.00,5,58
8,240,0,3,243,-76.00,5,36
8,240,0,3,243,-56.00,2,34
5,159,9,4,172,-73.00,4,54
8,240,0,3,243,-56.00,3,37
3,106,20,3,129,-77.00,3,54
8,240,0,3,243,-51.00,2,54
8,240,0,3,243,-71.00,4,59
8,240,0,3,243,-49.00,4,39
1,52,1888,3,1943,-59.00,3,61
3,106,780,4,890,-77.00,2,51
8,240,0,3,243,-62.00,2,33
3,106,19,4,129,-50.00,1,48
8,240,0,3,243,-56.00,1,60
8,240,0,3,243,-77.00,1,54
0,25,277,3,305,-74.00,1,33
8,241,0,3,244,-48.00,1,36
0,25,403,3,431,-58.00,1,62
8,240,0,3,243,-75.00,1,52
8,240,0,3,243,-77.00,1,35
8,240,0,3,243,-70.00,1,33
4,133,19,4,156,-59.00,1,40
8,240,0,3,243,-48.00,1,51
5,159,9,4,172,-58.00,1,62
8,240,0,3,243,-73.00,1,52
4,133,20,3,156,-74.00,1,37
8,240,0,3,243,-73.00,1,36
8,240,0,3,243,-54.00,1,37
8,240,0,3,243,-48.00,1,56
0,25,292,3,320,-58.00,2,62
8,240,0,3,243,-71.00,2,52
8,240,0,3,243,-74.00,2,39
5,159,9,3,171,-72.00,2,36
8,240,0,3,243,-56.00,2,38
8,241,0,3,244,-72.00,2,54
1,52,196,3,251,-74.00,1,38
8,241,0,3,244,-73.00,1,36
8,240,0,3,243,-55.00,1,37
4,133,20,3,156,-74.00,1,55
8,240,0,3,243,-77.00,1,36
1,52,241,3,296,-50.00,1,33
8,240,0,3,243,-59.00,1,60
3,106,19,4,129,-52.00,1,51
8,241,0,3,244,-55.00,1,58
8,240,0,3,243,-52.00,1,55
8,240,0,3,243,-56.00,1,58
8,240,0,3,243,-51.00,1,54
3,106,19,3,128,-59.00,1,59
8,240,0,3,243,-71.00,1,51
3,106,19,3,128,-62.00,1,39
8,241,0,3,244,-72.00,2,48
8,240,0,3,243,-64.00,2,38
0,25,113,3,141,-72.00,2,46
8,241,0,3,244,-63.00,2,38
8,240,0,3,243,-49.00,2,47
3,107,19,4,130,-66.00,2,61
8,240,0,3,243,-76.00,2,44
6,186,10,3,199,-55.00,2,34
8,240,0,3,243,-49.00,2,55
8,241,0,3,244,-57.00,2,61
3,107,20,3,130,-49.00,2,53
8,241,0,3,244,-66.00,2,61
8,241,0,3,244,-74.00,2,44
8,241,0,3,244,-58.00,2,36
3,107,20,3,130,-50.00,2,52
8,241,0,3,244,-62.00,2,60
8,241,0,3,244,-71.00,2,48
8,241,0,3,244,-61.00,2,39
8,241,0,3,244,-72.00,2,49
3,107,20,3,130,-64.00,1,38
8,241,0,3,244,-73.00,1,46
0,25,353,3,381,-65.00,1,37
8,240,0,3,243,-72.00,1,45
8,241,0,3,244,-67.00,1,38
